020608000
580889700
000040000
370000500
600000004
008000013
000020000
009800036
000306090