000260701
680070090
190004500
820700040
004602900
050003028
009300074
040050036
703018000