---26-7-1
68--7--9-
19---45--
82-7---4-
--46-29--
-5---3-28
--93---74
-4--5--36
7-3-18---